WWWWWWWWWJJJJJWWWWWWWWW
WWWWWWWWWJJJJJWWWWWWWWW
WWWWWWWWWJJJJJWWWWWWWWW
WWWWWWWWWJJJJJWWWWWWWWW
WWWWWWWWWWWWWWWWWWWWWWW
WWWWWWWWFFFFFFFWWWWWWWW
WWWWWWWWFFFFFFFWWWWWWWW
WWWWWWWWWWWWWWWWWWWWWWW
WWWWWWWWWDDDDDWWWWWWWWW
WWWWWWWWWDDDDDWWWWWWWWW
WWWWWWWWWWWWWWWWWWWWWWW