KKKKKKKKKKKKKKKKKKKKK5O
KGGGGGGGGGGGGGGGGGGGGGK
GbGGBGGGGGkkGGGjGGkkGGK
PPPPPPPPPGkkGGGGGGkkGGK
GGGGGGGGPGGGGGhhGGGGGGK
KGkkGjGBPGGbGGhhGGGGGGK
KGkkGGGGPGGGGGGGGGGGGGG
KGGGGhhGPGBGGGGGBGGGCCC
KGGbGhhGPPPPPPPPPPPPCCC
KGGGGGGGGGGGGGGGbGGGCCC
KKKKKKKKKKKKKKKKKKKKKKK