GGGPGGGnGGGGGrGGGGGGG5O
GnGPGGGBGGtGGGGzGGGxGGG
GGGPPPPPPPPPGGGzGGGxGGG
GGxGGGGGGGGPBGGGGBGGgGG
rGxGGGgGGGGPPPPPPPGGGGG
GGGgGGGBGGGGGGGGGPGGyGG
GGGGGPPPPPPPPPPPPPGGGGG
GGgGGPGGnGGGGGgGGrGGGgG
GGGGCCCGGGGzGGGGGGGyGGG
GgGGCCCGGGGzG77GtGGGGGG
GGGGCCCGGtGGG77GGGyGGGG