ccGGGPGGmGGGGGGGGGGGG5O
ccGGGPGGGsGGKGmGGGGGccG
GGGGBPGGKGBGGGGGKGGGccG
PPPPPPPPPPPPPPPGGKGGGGG
GKGGGPGppppppGPGssGGKGG
GsGGGPGppppppGPGssGGGGG
GGGKGPBppppppBPGGKGGCCC
GmGGKPPPPPPPPPPPPPPPCCC
GGGGaaGKGGGssGGGmGGKCCC
ccGGaaGGGGGssGGGGKGGGcc
ccGGGGGKGGGGGGmGGGsGGcc