WWWWWWWWWWWWWWWWWWWWWWV
WWWWWWWWWWWWWWWWWWWWWWW
WWWWWAAAAAWWWIIIIIWWWWW
WWWWWAAAAAWWWIIIIIWWWWW
WWWWWAAAAAWWWIIIIIWWWWW
WWWWWWWWWWWWWWWWWWWWWWW
WWWWWEEEEEWWWUUUUUWWWWW
WWWWWEEEEEWWWUUUUUWWWWW
WWWWWEEEEEWWWUUUUUWWWWW
WWWWWWWWWWWWWWWWWWWWWWW
WWWWWWWWWWWWWWWWWWWWWWW