WWWWMMMMMMMMMMMMMMMWWWW
WWWWWWWWWWWWWWWWWWWWWWW
WWWWWWWWWYYYYYWWWWWWWWW
WWWWWWWWWYYYYYWWWWWWWWW
WWWWWWWSSSSSSSSSWWWWWWW
WWWWWWWSSSSSSSSSWWWWWWW
WWWWWWWWTTTTTTTWWWWWWWW
WWWWWWWWTTTTTTTWWWWWWWW
WWWWWWWWWQQQQQWWWWWWWWW
WWWWWWWWWQQQQQWWWWWWWWW
WWWWWWWWWWWWWWWWWWWWWWW