WWWWWWWWWWWWWWWWWWWWWWV
WWWWWWWWWWWWWWWWWWWWWWW
WWWWWWWWWWWWWWWWWWWWWWW
WWWWWWWW6666666WWWWWWWW
WWWWWWWW6666666WWWWWWWW
WWWWWWWWWWWWWWWWWWWWWWW
WWWWWWWWWLLLLLWWWWWWWWW
WWWWWWWWWLLLLLWWWWWWWWW
WWWWWWWWWWWWWWWWWWWWWWW
WWWWWWWWWWWWWWWWWWWWWWW
WWWWWWWWWWWWWWWWWWWWWWW