WWWWWWWWWWWWWWWWWWWWWWW
WWWWWWWWRRRRRRRWWWWWWWW
WWWWWWWWRRRRRRRWWWWWWWW
WWWWWWWWFFFFFFFWWWWWWWW
WWWWWWWWFFFFFFFWWWWWWWW
WWWWWWWSSSSSSSSSWWWWWWW
WWWWWWWSSSSSSSSSWWWWWWW
WWWWWWWWWZZZZZWWWWWWWWW
WWWWWWWWWZZZZZWWWWWWWWW
WWWWWWWWWDDDDDWWWWWWWWW
WWWWWWWWWDDDDDWWWWWWWWW