WWWWWWWWWWWWWWWWWWWWWWW
WWWWWWWWWWWWWWWWWWWWWWW
WWWWWWWWWWWWWWWWWWWWWWW
WWWWHHHHHHHHHHHHHHHWWWW
WWWWHHHHHHHHHHHHHHHWWWW
WWWWHHXXXHHHHHNNNHHWWWW
WWWWHHXXXHHHHHNNNHHWWWW
WWWWWHHHHHHHHHHHHHHWWWW
WWWWWWWWWWWWWWWWWWWWWWW
WWWWWWWWWWWWWWWWWWWWWWW
WWWWWWWWWWWWWWWWWWWWWWW