WWWWWWWWWWWWWWWWWWWWWWV
WWWWWW111WWWWW222WWWWWW
WWWWWW111WWWWW222WWWWWW
WWWWWW111WWWWW222WWWWWW
WWWWWW111WWWWW222WWWWWW
WWWWWWWWWWWWWWWWWWWWWWW
WWWWWW333WWWWW444WWWWWW
WWWWWW333WWWWW444WWWWWW
WWWWWW333WWWWW444WWWWWW
WWWWWW333WWWWW444WWWWWW
WWWWWWWWWWWWWWWWWWWWWWW